%%%%%%%%%%%%%%%%%%%%%%
%                    %
%   S                %
%                    %
%    B               %
%                    %
%                    %
%                    %
%                 A  %
%                    %
%%%%%%%%%%%%%%%%%%%%%%
