%%%%%%%%%%%%%%%%%%%%%%
%                  A %
%   S                %
%              B     %
% A                  %
%                    %
%                    %
%      A             %
%              S     %
%                    %
%%%%%%%%%%%%%%%%%%%%%%
