######################
#           A        #
#   S                #
#                    #
#                    #
#                    #
#                    #
#                    #
#           A    S   #
#                    #
######################
